:-)	Your basic smiley. This smiley is used to inflect a sarcastic or joking statement since we can't hear voice inflection over e-mail.
=))	Full of laughing
;-)	Winky smiley. User just made a flirtatious and/or sarcastic remark.More of a "don't hit me for what I just said" smiley.
:-(	Frowning smiley. User did not like that last statement or is upset or depressed about something.
:-I	Indifferent smiley. Better than a `:-(' but not quite as good as a `:-)'.
:->	User just made a really biting sarcastic remark. Worse than a `;-)'.
>:->	User just made a really devilish remark.
>;->	Winky and devil combined. A very lewd remark was just made.
(-:	User is left handed.
%-)	User has been staring at a green screen for 15 hours straight.
:*)	User is drunk.
[:]	User is a robot.
8-)	User is wearing sunglasses.
B:-)	Sunglasses on head.
::-)	User wears normal glasses.
B-)	User wears horn-rimmed glasses.
8:-)	User is a little girl.
:-)-8	User is a Big girl.
:-{)	User has a mustache.
:-{}	User wears lipstick.
{:-)	User wears a toupee.
}:-(	Toupee in an updraft.
:-[	User is a vampire.
:-E	Bucktoothed vampire.
:-F	Bucktoothed vampire with one tooth missing.
:-7	User juust made a wry statement.
:-*	User just ate something sour.
:-)~	User drools.
:-~)	User has a cold.
:'-(	User is crying.
:'-)	User is so happy, s/he is crying.
:-@	User is screaming.
:-#	User wears braces.
:^)	User has a broken nose.
:v)	User has a broken nose, but it's the other way.
:_)	User's nose is sliding off of his face.
:<)	User is from an Ivy League School.
:-&	User is tongue tied.
3:[	Mean Pet smiley.
d8=	Your pet beaver is wearing goggles and a hard hat.
E-:-)	User is a Ham radio operator.
:-9	User is licking his/her lips.
-6%	User is braindead.
[:-)	User is wearing a walkman.
(:I	User is an egghead.
<:-I	User is a dunce.
K:P	User is a little kid with a propeller beenie.
@:-)	User is wearing a turban.
:-0	No Yelling!(Quiet Lab)
:-:	Mutant smiley; the invisible smiley.
.-)	User only has one eye.
,-)	Ditto...but he's winking.
X-(	User just died.
8 :-)	User is a wizard.
-=* :-)	User is a TeX wizard.
:)	Midget smiley.
:]	Gleep...a friendly midget smiley who will gladly be your friend.
=)	Variation on a theme...
:}	What should we call these? (what?)
:)	Happy.
:>	What?
:@	What?
:D	Laughter.
:I	Hmmm...
:(	Sad.
:[	Real Downer.
:<	What?
:{	What?
:O	Yelling.
:C	What?
:Q	What?
:,(	Crying.
[]	Hugs and ...
:*	Kisses.
|I	Asleep.
^o	Snoring.
C=}>;*{))	1A drunk, devilish chef with a toupee in an updraft, a mustache, and a double chin.
}:^#})	Updrafted bushy-mustached pointy nosed smiley with a double-chin.
~~:-(	Net.flame
O |-)	Net.religion
8 :-I	Net.unix-wizards
X-(	Net.suicide
E-:-I	Net.ham-radio
:-)	ha ha
|-)	hee hee
|-D	ho ho
:->	hey hey
:-(	boo hoo
:-I	hmmm
:-O	oops
:-P	nyahhhh!
^_^	Smile
^_-	Wink
^-^	Satisfied Smile
^-~	Wink
G	Giggle or grin
H	Hug
K	Kiss
S	Smile
T	Tickle
W	Wink
2MFM	To much for me
2U2	To you too
4AYN	For all you know
4COL	For crying out loud
4SALE	For sale
4U	For you
=W=	Whatever
>U	Screw you!
?	Huh?
?4U	Question for you
A/S/L	Age/Sex/Location
AAMOF	As a matter of fact
ABFL	A big fat lady
ABT	About
AKA	Also known as
AML	All my love
ANFSCD	And now for something completely different
ASAP	As soon as possible
ASL	Assistant section leader
ASOP	Assistant system operator
ATM	At the moment
AWA	As well as
AWGTHTGTTA	Are we going to have to go trough this again?
AWHFY	Are we having fun yet?
AWOL	Away without leave
AWOL	Absent without leave
AYOR	At your own risk
AYPI?	And your point is?
B	Back
B/C	Because
B/F	Boyfriend
B4	Before
B4N	Bye for now
BAC	Back at computer
BAG	Busting a gut
BAK	Back at the keyboard
BBIAB	Be back in a bit
BBL	Be back later
BBLBNTSBO...	Be back later but not to soon because of...
BBR	Burnt beyond repair
BBS	Bulletin board system
BBS	Be back soon
BC	Be cool
BC	Because
BCNU	Be Seein' You
BEG	Big evil grin
BF	Boyfriend
BFN	Bye for now
BG	Big grin
BICBW	But I could be wrong
BION	Believe it or not
BIOYIOB	Blow it out your I/O port
BITMT	But in the meantime
BKA	Better known as
BTSOOM	Beats the shit out of me
BTW	By the way
BUDWEISER	Because you deserve what every individual should ever receive
BWQ	Buzz word quotient
BWTHDIK	But what the heck do I know
BYOB	Bring your own bottle
BYOH	Bat You Onna Head
C&G	Chuckle and grin
CAD	Ctrl-alt-delete
CADET	Can't add, doesn't even try
CDIWY	Couldn't do it without you
CFN	Ciao for now
CFS	Care for secret?
CFV	Call for votes
CFY	Calling for you
CID	Crying in disgrace
CID	Consider it done
CIM	CompuServe information manager
CLM	Career limiting move
CM@TW	Catch me at the web
CMIIW	Correct me if I'm wrong
CNP	Continue in next post
CO	Conference
CRAFT	Can't remember a frighten thing
CRS	Can?t remember shit
CSG	Chuckle snicker grin
CTS	Changing the subject
CU	See you
CU2	See you too
CUL	See you later
CUL8R	See you later
CWOT	Complete waste of time
CWYL	Chat with you later
CYA	See ya
CYAL8R	See ya later
CYO	See you online
DBA	Doing business as
DCED	Disconnected
DFLA	Disenhanced four-letter acronym
DGA	Digital guardian angel
DH	Darling husband
DIIK	Darn if i know
DIKU	Do I know you?
DITYID	Did I tell you I'm distressed
DIY	Do it yourself
DL	Download
DL	Dead link
DLTBBB	Don't let the bad bugs bite
DMMGH	Don't make me get hostile
EG	Evil grin
EIE	Enough is enough
EMFJI	Excuse me for jumping in
EMSG	Email message
EOD	End of discussion
EOF	End of file
EOL	End of lecture
EOM	End of message
EOT	End of thread
ETLA	Extended three letter acronym
F	Female
F/F	Face to face
F2F	Face to face
FAQ	Frequently asked questions
FAWC	For anyone who cares
FBOW	For better or worse
FBTW	Fine, be that way
FCFS	First come, first served
FCOL	For crying out loud
FIFO	First in, first out
FISH	First in, still here
FUD	Fear, uncertainty and doubt
FURTB	Full up ready to burst (about hard disk drives)
FW	Freeware
FW	Forward
FWIW	For what it's worth
FYA	For your amusement
FYE	For your entertainment
FYEO	For your eyes only
FYI	For your information
G	Grin
G&BIT	Grin and bear it
G2B	Going to bed
G2G	Got to go
G2GGS2D	Got to go get something to drink
GA	Go ahead
GA	Good afternoon
GL&GH	Good luck and good hunting
GM	Good match
GM	Good move
GM	Good morning
GMAB	Give me a break
GMTA	Great minds think alike
GN	Good night
GOK	God only knows
GOWI	Get on with it
GPF	General protection fault
GR&D	Grinning, running and ducking
GR8	Great
GRA	Go right ahead
GTG	Gotta go
GTG	Got to go
GTSY	Glad to see you
GW	Good work
H	Hug
H&K	Hug and kiss
H/O	Hold on
HAG1	Have a good one
HAGD	Have a good day
HOAS	Hold on a second
HSIK	How should i know
HT	Hi there
HTH	Hope this helps
HTHBE	Hope this has been enlightening
HYLMS	Hate you like my sister
IAAA	I am an accountant
IAAL	I am a lawyer
IAC	In any case
IAE	In any event
IAG	It's all good
IAIM	In an Irish minute
IANAA	I am not an accountant
IANAL	I am not a lawyer
IBN	I'm bucked naked
IC	I see
ICOCBW	I could of course be wrong
IDC	I don't care
IDGI	I don't get it
IDGW	In a good way
IDI	I doubt it
IDK	I don't know
IDTT	I'll drink to that
IFVB	I feel very bad
IGP	I gotta pee
IGTP	I get the point
IHTFP	I have truly found paradise
IHTFP	I hate this fountain place
IHU	I hate you
IHY	I hate you
II	I?m impressed
IIR	If I recall
IIRC	If I recall correctly
IIT	I?m impressed too
IJWTK	I just want to know
IJWTS	I just want to say
IK	I know
IKWUM	I know what you mean
ILBCNU	I"ll be seeing you
ILU	I love you
ILY	I love you
ILYFAE	I love you forever and ever
IM	Instant message
IMAO	In my arrogant opinion
IMBO	In my bloody opinion
IMCO	In my considered opinion
IME	In my experience
IMFAO	In my fooling arrogant opinion
IMHO	In my humble opinion
IMNSHO	In my, not so humble opinion
IMO	In my opinion
IMOBO	In my own biased opinion
IMP	I might be pregnant
IMPOV	In my point of view
IMS	I am sorry
INAL	I'm not a lawyer
INPO	In no particular order
IOIT	I'm on Irish Time
JIC	Just in case
JJWY	Just joking with you
JK	Just kidding
JMHO	Just my humble opinion
JMO	Just my opinion
JP	Just playing
JTLYK	Just to let you know
JW	Just wondering
K	Okay
K	Kiss (rarely used)
KB	Kiss back
KHYF	Know how you feel
KIS	Keep it simple
KISS	Keep it simple stupid
KISS	Keep it simple sister
KISS	Keeping it sweetly simple
KIT	Keep in touch
KOTC	Kiss on the cheek
KOTL	Kiss on the lips
KUTGW	Keep up the good work
KWIM	Know what I mean?
L	Laugh
L8R	Later
L8R G8R	Later gator
LAB	Life's a bitch
LBR	Little boys room
LD	Long distance
LGR	Little girls room
LHM	Lord help me
LHU	Lord help us
LL&P	Live long & prosper
LMA	Leave me alone
LMHO	Laughing my head off
LMK	Let me know
LNK	Love and kisses
LOL	Laughing out loud
LOL	Lots of luck
LOL	Lots of love
LOLA	Laughing out loud again
LOML	Light of my life (or love of my life)
LOMLILY	Light of my life, I love you
LOOL	Laughing out outrageously loud
LSHIPMP	Laughing so hard I pissed my pants
LSHMBB	Laughing so hard my belly is bouncing
LSHMBH	Laughing so hard my belly hurts
LTNS	Long time no see
LTR	Long term relationship
LTS	Laughing to self
LULAS	Love you like a sister
LUWAMH	Love you with all my heart
LY	Love ya
LYK	Let you know
LYL	Love ya lots
LYLAB	Love ya like a brother
LYLAS	Love ya like a sister
M	Male
M8	Mate
MB	Maybe
MYOB	Mind your own business
N	In
N/C	Not cool
N/M	Never mind / nothing much
N/S	No shit
N2M	Not too much
NBD	No big deal
NE1	Anyone
NETUA	Nobody ever tells us anything
NFI	No found idea
NL	Not likely
NM	Never mind / nothing much
NMH	Not much here
NMJC	Nothing much, just chillin'
NOM	No offense meant
NOTTOMH	Not of the top of my mind
NOYB	None of your business
NOYFB	None of your failing business
NP	No problem
NRN	No response necessary
NS	No shit
NTA	Non-technical acronym
NVM	Nevermind
OBTW	Oh, by the way
OF	On fire
OFIS	On floor with stitches
OH	Off hand
OIC	Oh, I see
OIC	Oh I see
OK	Abbreviation of oll korrect (all correct)
OL	Old lady (wife, girlfriend)
OM	Old man (husband, boyfriend)
OMG	Oh my god / gosh / goodness
OOC	Out of character
OT	Off topic / other topic
OTOH	On the other hand
OTP	On the phone
OTTOMH	Off the top of my head
PAW	Parents are watching
PDS	Please don't shoot
PEBCAK	Problem exists between chair and keyboard
PLS	Please
PLZ	Please
PM	Private message
PMFJI	Pardon me for jumping in
PMJI	Pardon my jumping in (Another way for PMFJI)
PMP	Peed my pants
POAHF	Put on a happy face
POC	Point of contact
POOF	I have left the chat
POS	Parents over shoulder
POTB	Pats on the back
POV	Point of view
PPL	People
PS	Post script
PSA	Public show of affection
Q4U	Question for you
QSL	Reply
QSO	Conversation
QT	Cutie
RCED	Reconnected
RE	Hi again (same as re's)
ROFL	Rolling on floor laughing
ROFLOLAY	Rolling on floor laughing out loud at you
ROFLOLTSDMC	Rolling on floor laughing out loud tears streaming down my cheeks
ROFLOLUTS	Rolling on floor laughing out loud unable to speak
ROFLOLWTIME	Rolling on floor laughing out loud with tears in my eyes
ROTFL	Rolling on the floor laughing
RSN	Real soon now
RTF	Read the FAQ
RTSM	Read the stupid manual
RUOK?	Are you okay?
RUTTM	Are you talking to me
RVD	Really very dumb
S2R	Send to receive
SAMAGAL	Stop annoying me and get a live
SCNR	Sorry, could not resist
SETE	Smiling ear to ear
SH	Same here
SH	So hot
SHICPMP	So happy I could piss my pants
SHID	Slaps head in disgust
SHMILY	See how much I love you
SIM	Shit, it's Monday
TIIC	The idiots in charge
TJM	That's just me
TLA	Three-letter acronym
TMA	Take my advice
TMI	To much information
TNSTAAFL	There's no such thing as a free lunch
TNX	Thanks
TOH	To other half
TOY	Thinking of you
TPTB	The powers that be
TSDMC	Tears streaming down my cheeks
TT2T	To tired to talk
TTFN	Ta ta for now
TTT	Thought that, too
TTUL	Talk to you later
TTYL	Talk to you later
TTYLMF	Talk to you later my friend
TU	Thank you
TWMA	Till we meet again
TX	Thanx
TY	Thank you
TYVM	Thank you very much
U2	You too
UR	Your
URAQT!	You are a cutie!
UW	You're welcom
VBG	Very big grin
VBS	Very big smile
W/E	Whatever
W8	Wait
W8AM	Wait a minute
WAY	Who are you
WB	Welcome back
WBS	Write back soon
WDHLM	Why doesn't he love me
WE	Whatever
WFM	Works for me
WNDITWB	We never did it this way before
WP	Wrong person
WRT	With respect to
WTF	What/who the fool?
WTG	Way to go
WTGP	Want to go private?
WTH	What/who the heck?
WTMI	Way to much information
WU	What's up?
WU?	What's up?
WUD	What's up dog?
WUF	Where are you from?
WUWT	Whats up with that
WYMM	Will you marry me?
WYSIWYG	What you see is what you get
XTLA	Extended three letter acronym
Y	Why?
Y2K	You're too kind
YATB	You are the best
YBS	You'll be sorry
YG	Young gentleman
YHBBYBD	You'd have better bet your bottom dollar
YL	Young lady
YL	You 'll live
YM	You mean
YMMD	You've made my day
YMMV	Your mileage may vary
YOYO	You're on your own
YT?	You there?
YVW	You're very welcome
YW	You are welcome
YWIA	You're welcome in advance
YWTKM	You want to kiss me
YWTLM	You want to love me
YY4U	Two wise for you
n00b	Leetspeak for beginner